1111111111111
1001000000PC1
10C000N000001
10C011E000C01
1111111111111