1111111111111111111111111111111
100000000C000000000C00000000001
10000010N00000E0000000001111001
10000010000C0000000C00000001001
10000010000000000000000011110P1
1000001010000000000000001000001
1000001111000000000000001111001
1C000000100000C00000000000000C1
1111111111111111111111111111111